111111111111111111111111111111111111111111111111111111111111
1CCCCCCCCCCCCCCCCCCCCCCCCCCCCCCCCCCCCCCCCCCCCCCCCCCCCCCCCCC1
1C00000000000000000000000000000000000000000000000000000000C1
1C00000000000000000000000000000000000000000000000000000000C1
1C00000000000000000000011111110011111111111111100000000000C1
1C0000000000000000000001MMMM11001MMMM11MMMMMMM100000000000C1
1C000000000000000000111MMMM100001MMM1001MMMMMM100000000000C1
1C0000000000000000001MMMMM1100001M110001MMMMMM100000000000C1
1C000000000000000011MMMM1000000011000001MMMMMM100000000000C1
1C00000000000000001MMMM11000000010000001MMMMMM100000000000C1
1C0000000000000111MMMM100000000000000001MMMMM1000000000000C1
1C00000000000001MMMM11100000000000000001MMMM11000000000000C1
1C0000000000011MMMM10000000000000000111MMMM100000000000000C1
1C000000000001MMMM1100000000000000001MMMM11100000000000000C1
1C00000000001MMMM1000000000000000011MMMM100000000000000000C1
1C00000000001MMM1100000000000000001MMMM1100000000000000000C1
1C00000000001MM1000000000000000011MMMM10000000000000000000C1
1C00000000001MM100000000000000001MMMMM10000000000000000000C1
1C00000000001MM111111111111111001MMMMM10000011100000000000C1
1C00000000001MMMMMMMMMMMMMMMM1001MMMMM1000001M100000000000C1
1C00000000001MMMMMMMMMMMMMMMM1001MMMMM1000001M100000000000C1
1C0000000000111111111111MMMMM1001MMMMM1000111M100000000000C1
1C0000000000000000000001MMMMM1001MMMMM1011MMMM100000000000C1
1C0000000000000000000001MMMMM10011111110111111100000000000C1
1C0000000000000000000001MMMMM10000000000000000000000000000C1
1C0000000000000000000001MMMMM10000000000000000000000000000C1
1C00000000000000000000011111110000000000000000000000000000C1
1C0000000000000000000000000000M000000000000000000000000000C1
1PECCCCCCCCCCCCCCCCCCCCCCCCCCCCCCCCCCCCCCCCCCCCCCCCCCCCCCCC1
111111111111111111111111111111111111111111111111111111111111