111111111111111111111111111111111111111111111111111111111111
10000000000M0000000000000000000M00000000000000000M0000000001
100000000000000000000000000000000000000000000000000000000001
100000000000000000000000000111111111100000000000000000000001
1000000M000000000M000000000111110000100000000000000000000001
10000000000000000000000000000000000M10000000000CEC0000000001
10M0C00000M0C0000M0C0000C0M111000111100000000000000000000001
111111111111111111111111111100M00001100000000000000000000001
11111111111111111111111111110000M001100000000000000000000001
111111111111111111111111111111101111111111111111111111111111
11111111111111111111111111MMM11011MMM11111111111111111111111
111111111111111111111111111110000011111111111111111111111111
1111111111111111111111111111M00000M1111111111111111111111111
111111111111111111111111111110000011111111111111111111111111
1111111111111111111111111111M00000M1111111111111111111111111
101111111111111111111111111110000011111111111111111111111111
111111111111111111111111111110000011111111111111111111111111
111000001C10000000000000000000000000000000000000000000000001
11101110101000000000000CM000000000000000C0000000000000000001
100000101010000000000000001000000000010000000000000000000001
10000M10101000000000000C000000000000000MC0000000000000000001
1M0000101010000000000000001000000000010000000000000000000001
10000010101000000000000CM000000000000000C0000000000000000001
111011101010000000000000000000000000000000000000000000000001
111P11100000000000000000000000000000000000000000000000000001
111111111111111111111111111111111111111111111111111111111111
