1111111111
1C000000M1
1111111001
1M00000001
110C0M0C01
1000000001
101C0M0C01
1110000001
1CE00000P1
1111111111
