11111111111111111111
1C0000000000000000M1
11000000111111111001
100M00M0010000000001
10000000000000000001
100000000000010MP1E1
11111111111111111111